#####################
#@...........#o.....#
#...#......#...###.o#
#.....#.....x...#...#
##...x##............#
#..........x.#......#
#.......#......o....#
#####################
--By 175314107_OktaVadindaP