#####################
#............#.....o#
#..#x##......#.....o#
#.....#.....x#......#
#...x..............o#
#..####......#......#
#@..................#
#####################
--by okta 175314107